_______________________
|           * |       |
| _ _ _ _     |     N |
|       |     |       |
|   N   D     _ D _ _ |
|       |             |
| _ _ _ |   O         |
|                     |
|                   T |
|   T   |     | D _ _ |
|       |     |     N |
________| G G |________