_ _ _ _ _ _ _ _ _ _ _ _
|           * |       |
| _ _ _ _     |     N |
|       |     |       |
|   N   D     _ D _ _ |
|       |             |
| _ _ _ |   O         |
|                     |
|                   T |
|   T   | H H | D _ _ |
|       | H H |     N |
_ _ _ _ | G G | _ _ _ _
